"filename", "language", "HTML", "Markdown", "JavaScript", "CSS", "PHP", "comment", "blank", "total"
"/Users/timshu/Library/Mobile Documents/com~apple~CloudDocs/Timshu/10.小树科技/12.小树NexThing/02.code/NexThing 2/404.html", "HTML", 24, 0, 0, 0, 0, 1, 1, 26
"/Users/timshu/Library/Mobile Documents/com~apple~CloudDocs/Timshu/10.小树科技/12.小树NexThing/02.code/NexThing 2/README.md", "Markdown", 0, 3, 0, 0, 0, 0, 1, 4
"/Users/timshu/Library/Mobile Documents/com~apple~CloudDocs/Timshu/10.小树科技/12.小树NexThing/02.code/NexThing 2/css/HomPage_Style.css", "CSS", 0, 0, 0, 70, 0, 0, 11, 81
"/Users/timshu/Library/Mobile Documents/com~apple~CloudDocs/Timshu/10.小树科技/12.小树NexThing/02.code/NexThing 2/css/next.css", "CSS", 0, 0, 0, 16, 0, 0, 4, 20
"/Users/timshu/Library/Mobile Documents/com~apple~CloudDocs/Timshu/10.小树科技/12.小树NexThing/02.code/NexThing 2/css/style.css", "CSS", 0, 0, 0, 78, 0, 2, 12, 92
"/Users/timshu/Library/Mobile Documents/com~apple~CloudDocs/Timshu/10.小树科技/12.小树NexThing/02.code/NexThing 2/css/time.css", "CSS", 0, 0, 0, 50, 0, 0, 5, 55
"/Users/timshu/Library/Mobile Documents/com~apple~CloudDocs/Timshu/10.小树科技/12.小树NexThing/02.code/NexThing 2/css/yiyan.css", "CSS", 0, 0, 0, 33, 0, 0, 5, 38
"/Users/timshu/Library/Mobile Documents/com~apple~CloudDocs/Timshu/10.小树科技/12.小树NexThing/02.code/NexThing 2/index.html", "HTML", 59, 0, 0, 0, 0, 3, 5, 67
"/Users/timshu/Library/Mobile Documents/com~apple~CloudDocs/Timshu/10.小树科技/12.小树NexThing/02.code/NexThing 2/index_back.html", "HTML", 24, 0, 0, 0, 0, 0, 2, 26
"/Users/timshu/Library/Mobile Documents/com~apple~CloudDocs/Timshu/10.小树科技/12.小树NexThing/02.code/NexThing 2/js/HomPage_Script.js", "JavaScript", 0, 0, 65, 0, 0, 8, 19, 92
"/Users/timshu/Library/Mobile Documents/com~apple~CloudDocs/Timshu/10.小树科技/12.小树NexThing/02.code/NexThing 2/js/NexThing_jinritoutiao.js", "JavaScript", 0, 0, 40, 0, 0, 7, 6, 53
"/Users/timshu/Library/Mobile Documents/com~apple~CloudDocs/Timshu/10.小树科技/12.小树NexThing/02.code/NexThing 2/js/NexThing_news.js", "JavaScript", 0, 0, 42, 0, 0, 8, 6, 56
"/Users/timshu/Library/Mobile Documents/com~apple~CloudDocs/Timshu/10.小树科技/12.小树NexThing/02.code/NexThing 2/js/NexThing_toutiao.js", "JavaScript", 0, 0, 29, 0, 0, 9, 7, 45
"/Users/timshu/Library/Mobile Documents/com~apple~CloudDocs/Timshu/10.小树科技/12.小树NexThing/02.code/NexThing 2/js/NexThing_weibo.js", "JavaScript", 0, 0, 29, 0, 0, 9, 7, 45
"/Users/timshu/Library/Mobile Documents/com~apple~CloudDocs/Timshu/10.小树科技/12.小树NexThing/02.code/NexThing 2/js/lizhi.js", "JavaScript", 0, 0, 39, 0, 0, 6, 8, 53
"/Users/timshu/Library/Mobile Documents/com~apple~CloudDocs/Timshu/10.小树科技/12.小树NexThing/02.code/NexThing 2/js/login.js", "JavaScript", 0, 0, 30, 0, 0, 1, 5, 36
"/Users/timshu/Library/Mobile Documents/com~apple~CloudDocs/Timshu/10.小树科技/12.小树NexThing/02.code/NexThing 2/js/script.js", "JavaScript", 0, 0, 24, 0, 0, 4, 6, 34
"/Users/timshu/Library/Mobile Documents/com~apple~CloudDocs/Timshu/10.小树科技/12.小树NexThing/02.code/NexThing 2/js/seniorthing.js", "JavaScript", 0, 0, 21, 0, 0, 3, 1, 25
"/Users/timshu/Library/Mobile Documents/com~apple~CloudDocs/Timshu/10.小树科技/12.小树NexThing/02.code/NexThing 2/js/share.js", "JavaScript", 0, 0, 18, 0, 0, 8, 8, 34
"/Users/timshu/Library/Mobile Documents/com~apple~CloudDocs/Timshu/10.小树科技/12.小树NexThing/02.code/NexThing 2/js/things.js", "JavaScript", 0, 0, 107, 0, 0, 32, 19, 158
"/Users/timshu/Library/Mobile Documents/com~apple~CloudDocs/Timshu/10.小树科技/12.小树NexThing/02.code/NexThing 2/js/time.js", "JavaScript", 0, 0, 17, 0, 0, 0, 2, 19
"/Users/timshu/Library/Mobile Documents/com~apple~CloudDocs/Timshu/10.小树科技/12.小树NexThing/02.code/NexThing 2/js/yiyan.js", "JavaScript", 0, 0, 21, 0, 0, 3, 2, 26
"/Users/timshu/Library/Mobile Documents/com~apple~CloudDocs/Timshu/10.小树科技/12.小树NexThing/02.code/NexThing 2/pages/HomePage.html", "HTML", 32, 0, 0, 0, 0, 2, 2, 36
"/Users/timshu/Library/Mobile Documents/com~apple~CloudDocs/Timshu/10.小树科技/12.小树NexThing/02.code/NexThing 2/pages/NexThing_news.html", "HTML", 54, 0, 0, 0, 0, 1, 3, 58
"/Users/timshu/Library/Mobile Documents/com~apple~CloudDocs/Timshu/10.小树科技/12.小树NexThing/02.code/NexThing 2/pages/NexThing_radio.html", "HTML", 51, 0, 0, 0, 0, 1, 3, 55
"/Users/timshu/Library/Mobile Documents/com~apple~CloudDocs/Timshu/10.小树科技/12.小树NexThing/02.code/NexThing 2/pages/NexThing_toutiao.html", "HTML", 54, 0, 0, 0, 0, 1, 2, 57
"/Users/timshu/Library/Mobile Documents/com~apple~CloudDocs/Timshu/10.小树科技/12.小树NexThing/02.code/NexThing 2/pages/NexThing_toutiaonews.html", "HTML", 54, 0, 0, 0, 0, 1, 2, 57
"/Users/timshu/Library/Mobile Documents/com~apple~CloudDocs/Timshu/10.小树科技/12.小树NexThing/02.code/NexThing 2/pages/NexThing_weibo.html", "HTML", 54, 0, 0, 0, 0, 1, 3, 58
"/Users/timshu/Library/Mobile Documents/com~apple~CloudDocs/Timshu/10.小树科技/12.小树NexThing/02.code/NexThing 2/pages/SQL.html", "HTML", 99, 0, 0, 0, 0, 1, 8, 108
"/Users/timshu/Library/Mobile Documents/com~apple~CloudDocs/Timshu/10.小树科技/12.小树NexThing/02.code/NexThing 2/pages/calendar.html", "HTML", 83, 0, 0, 0, 0, 1, 7, 91
"/Users/timshu/Library/Mobile Documents/com~apple~CloudDocs/Timshu/10.小树科技/12.小树NexThing/02.code/NexThing 2/pages/clock.html", "HTML", 49, 0, 0, 0, 0, 1, 5, 55
"/Users/timshu/Library/Mobile Documents/com~apple~CloudDocs/Timshu/10.小树科技/12.小树NexThing/02.code/NexThing 2/pages/lizhi.html", "HTML", 26, 0, 0, 0, 0, 1, 2, 29
"/Users/timshu/Library/Mobile Documents/com~apple~CloudDocs/Timshu/10.小树科技/12.小树NexThing/02.code/NexThing 2/pages/loginadmin.html", "HTML", 29, 0, 0, 0, 0, 1, 4, 34
"/Users/timshu/Library/Mobile Documents/com~apple~CloudDocs/Timshu/10.小树科技/12.小树NexThing/02.code/NexThing 2/pages/next.html", "HTML", 31, 0, 0, 0, 0, 1, 1, 33
"/Users/timshu/Library/Mobile Documents/com~apple~CloudDocs/Timshu/10.小树科技/12.小树NexThing/02.code/NexThing 2/pages/police.html", "HTML", 42, 0, 0, 0, 0, 3, 13, 58
"/Users/timshu/Library/Mobile Documents/com~apple~CloudDocs/Timshu/10.小树科技/12.小树NexThing/02.code/NexThing 2/pages/seniorthing.html", "HTML", 54, 0, 0, 0, 0, 4, 1, 59
"/Users/timshu/Library/Mobile Documents/com~apple~CloudDocs/Timshu/10.小树科技/12.小树NexThing/02.code/NexThing 2/pages/things.html", "HTML", 163, 0, 0, 0, 0, 17, 15, 195
"/Users/timshu/Library/Mobile Documents/com~apple~CloudDocs/Timshu/10.小树科技/12.小树NexThing/02.code/NexThing 2/pages/yiyan.html", "HTML", 84, 0, 0, 0, 0, 1, 7, 92
"/Users/timshu/Library/Mobile Documents/com~apple~CloudDocs/Timshu/10.小树科技/12.小树NexThing/02.code/NexThing 2/php/english.php", "PHP", 0, 0, 0, 0, 23, 3, 4, 30
"/Users/timshu/Library/Mobile Documents/com~apple~CloudDocs/Timshu/10.小树科技/12.小树NexThing/02.code/NexThing 2/php/get_data.php", "PHP", 0, 0, 0, 0, 23, 7, 9, 39
"/Users/timshu/Library/Mobile Documents/com~apple~CloudDocs/Timshu/10.小树科技/12.小树NexThing/02.code/NexThing 2/php/get_lizhi.php", "PHP", 0, 0, 0, 0, 23, 7, 8, 38
"/Users/timshu/Library/Mobile Documents/com~apple~CloudDocs/Timshu/10.小树科技/12.小树NexThing/02.code/NexThing 2/php/insert.php", "PHP", 0, 0, 0, 0, 32, 11, 12, 55
"/Users/timshu/Library/Mobile Documents/com~apple~CloudDocs/Timshu/10.小树科技/12.小树NexThing/02.code/NexThing 2/php/jinritoutiao.php", "PHP", 0, 0, 0, 0, 23, 3, 3, 29
"/Users/timshu/Library/Mobile Documents/com~apple~CloudDocs/Timshu/10.小树科技/12.小树NexThing/02.code/NexThing 2/php/login.php", "PHP", 0, 0, 0, 0, 22, 5, 9, 36
"/Users/timshu/Library/Mobile Documents/com~apple~CloudDocs/Timshu/10.小树科技/12.小树NexThing/02.code/NexThing 2/php/logout.php", "PHP", 0, 0, 0, 0, 7, 0, 2, 9
"/Users/timshu/Library/Mobile Documents/com~apple~CloudDocs/Timshu/10.小树科技/12.小树NexThing/02.code/NexThing 2/php/process_add.php", "PHP", 0, 0, 0, 0, 20, 3, 4, 27
"/Users/timshu/Library/Mobile Documents/com~apple~CloudDocs/Timshu/10.小树科技/12.小树NexThing/02.code/NexThing 2/php/process_query.php", "PHP", 0, 0, 0, 0, 21, 8, 8, 37
"/Users/timshu/Library/Mobile Documents/com~apple~CloudDocs/Timshu/10.小树科技/12.小树NexThing/02.code/NexThing 2/php/seniorthing.php", "PHP", 0, 0, 0, 0, 22, 7, 9, 38
"/Users/timshu/Library/Mobile Documents/com~apple~CloudDocs/Timshu/10.小树科技/12.小树NexThing/02.code/NexThing 2/php/things.php", "PHP", 0, 0, 0, 0, 26, 9, 7, 42
"/Users/timshu/Library/Mobile Documents/com~apple~CloudDocs/Timshu/10.小树科技/12.小树NexThing/02.code/NexThing 2/php/toutiao.php", "PHP", 0, 0, 0, 0, 24, 4, 5, 33
"/Users/timshu/Library/Mobile Documents/com~apple~CloudDocs/Timshu/10.小树科技/12.小树NexThing/02.code/NexThing 2/php/upload.php", "PHP", 0, 0, 0, 0, 36, 6, 13, 55
"/Users/timshu/Library/Mobile Documents/com~apple~CloudDocs/Timshu/10.小树科技/12.小树NexThing/02.code/NexThing 2/php/weibo.php", "PHP", 0, 0, 0, 0, 24, 4, 5, 33
"/Users/timshu/Library/Mobile Documents/com~apple~CloudDocs/Timshu/10.小树科技/12.小树NexThing/02.code/NexThing 2/php/weixin.php", "PHP", 0, 0, 0, 0, 25, 1, 5, 31
"/Users/timshu/Library/Mobile Documents/com~apple~CloudDocs/Timshu/10.小树科技/12.小树NexThing/02.code/NexThing 2/php/yiyan.php", "PHP", 0, 0, 0, 0, 36, 14, 15, 65
"Total", "-", 1066, 3, 482, 247, 387, 234, 338, 2757